data,stato,codice_regione,denominazione_regione,lat,long,ricoverati_con_sintomi,terapia_intensiva,totale_ospedalizzati,isolamento_domiciliare,totale_positivi,variazione_totale_positivi,nuovi_positivi,dimessi_guariti,deceduti,casi_da_sospetto_diagnostico,casi_da_screening,totale_casi,tamponi,casi_testati,note,ingressi_terapia_intensiva,note_test,note_casi,totale_positivi_test_molecolare,totale_positivi_test_antigenico_rapido,tamponi_test_molecolare,tamponi_test_antigenico_rapido,codice_nuts_1,codice_nuts_2
2022-09-04T17:00:00,ITA,13,Abruzzo,42.35122196,13.39843823,124,7,131,27194,27325,70,464,511133,3639,,,542097,6726934,1311846,,0,,,217311,324786,2458699,4268235,ITF,ITF1
2022-09-04T17:00:00,ITA,17,Basilicata,40.63947052,15.80514834,35,0,35,7172,7207,77,143,171547,980,,,179734,1214305,383320,,0,,,69785,109949,685440,528865,ITF,ITF5
2022-09-04T17:00:00,ITA,18,Calabria,38.90597598,16.59440194,151,6,157,57097,57254,-700,717,481919,2959,,,542132,3689859,2826383,,3,,		 L'Asp di Catanzaro comunica 133 nuovi soggetti positivi di cui 6 fuori regione		 L'Asp di Cosenza comunica 265 nuovi soggetti positivi di cui 12 fuori regione.		 		,195504,346628,1777072,1912787,ITF,ITF6
2022-09-04T17:00:00,ITA,15,Campania,40.83956555,14.25084984,264,9,273,100416,100689,288,1346,2078194,11115,,,2189998,18650297,5195492,,1,,"a seguito delle verifiche odierne, si evince che i due decessi registrati oggi, risalgono ai giorni 20/08 e 31/08 2022",938436,1251562,9129737,9520560,ITF,ITF3
2022-09-04T17:00:00,ITA,08,Emilia-Romagna,44.49436681,11.3417208,809,30,839,20883,21722,-1061,1241,1787605,17905,,,1827232,17618006,2859542,,2,,,1025193,802039,9949428,7668578,ITH,ITH5
2022-09-04T17:00:00,ITA,06,Friuli Venezia Giulia,45.6494354,13.76813649,131,2,133,6162,6295,-286,297,465884,5373,,,477552,7052968,1196226,Il totale dei casi positivi Ã¨ stato ridotto di 1 a seguito di 1 test positivo rimosso dopo revisione del caso (caso relativo alla provincia di PN).		,0,,,220984,256568,3592906,3460062,ITH,ITH4
2022-09-04T17:00:00,ITA,12,Lazio,41.89277044,12.48366722,505,39,544,58774,59318,-881,1181,1953181,12006,,,2024505,23652167,5884033,,1,,,1015017,1009488,9198571,14453596,ITI,ITI4
2022-09-04T17:00:00,ITA,07,Liguria,44.41149315,8.9326992,178,3,181,6434,6615,-385,381,550135,5548,,,562298,6174342,1424737,,0,,*di cui 30107  reinfezioni a partire dal 3/09/2021 [circ. min sal. n.37911 del 20/08/2021].,258914,303384,2571028,3603314,ITC,ITC3
2022-09-04T17:00:00,ITA,03,Lombardia,45.46679409,9.190347404,569,13,582,41367,41949,-787,1862,3399293,42291,,,3483533,40878931,8704635,,0,,,1481782,2001751,16473201,24405730,ITC,ITC4
2022-09-04T17:00:00,ITA,11,Marche,43.61675973,13.5188753,77,3,80,5902,5982,2,451,596786,4094,,,606862,3476729,2474432,,1,,,220032,386830,2004331,1472398,ITI,ITI3
2022-09-04T17:00:00,ITA,14,Molise,41.55774754,14.65916051,11,1,12,4506,4518,95,94,82683,671,,,87872,720148,674696,,1,,,27803,60069,475393,244755,ITF,ITF2
2022-09-04T17:00:00,ITA,21,P.A. Bolzano,46.49933453,11.35662422,21,1,22,1745,1767,-154,87,252609,1530,,,255906,5340790,849355,"87 nuovi positivi di cui 1 test antigenici confermati da test molecolare, 84 casi diagnosticati con test antigenico e 2 nuovi positivi al test PCR. ",0,,"87 nuovi positivi di cui 1 test antigenici confermati da test molecolare, 84 casi diagnosticati con test antigenico e 2 nuovi positivi al test PCR. ",85992,169914,912460,4428330,ITH,ITH1
2022-09-04T17:00:00,ITA,22,P.A. Trento,46.06893511,11.12123097,65,1,66,2993,3059,-65,179,200279,1591,,,204929,2809180,583423,,0,,,43967,160962,856477,1952703,ITH,ITH2
2022-09-04T17:00:00,ITA,01,Piemonte,45.0732745,7.680687483,276,8,284,32788,33072,-111,778,1387633,13603,,,1434308,19082743,4169139,,1,,,510273,924035,5037854,14044889,ITC,ITC1
2022-09-04T17:00:00,ITA,16,Puglia,41.12559576,16.86736689,185,7,192,18073,18265,-219,521,1429795,9009,,,1457069,12508480,2632107,,0,,,500392,956677,4600222,7908258,ITF,ITF4
2022-09-04T17:00:00,ITA,20,Sardegna,39.21531192,9.110616306,85,7,92,9664,9756,59,201,427953,2723,,,440432,5041438,1716358,,0,,"L'incremento dei nuovi casi tiene conto anche dei casi diagnosticati con test antigenico. Pertanto si specifica che dei 201 casi dichiarati oggi, 195 sono stati diagnosticati da tampone antigenico.",172772,267660,2124417,2917021,ITG,ITG2
2022-09-04T17:00:00,ITA,19,Sicilia,38.11569725,13.3623567,379,24,403,67888,68291,225,820,1544564,12125,,,1624980,14906526,9295052,,2,,,523381,1101599,4965890,9940636,ITG,ITG1
2022-09-04T17:00:00,ITA,09,Toscana,43.76923077,11.25588885,231,8,239,80188,80427,-481,541,1288567,10665,,,1379659,15348405,5118277,,1,,,677360,702299,6938069,8410336,ITI,ITI1
2022-09-04T17:00:00,ITA,10,Umbria,43.10675841,12.38824698,127,1,128,2774,2902,-318,243,361733,2076,,,366711,4643518,773836,- Si fa presente che 50 dei ricoveri non UTI appartengono ad altri codici disciplina.,0,,,150564,216147,1696393,2947125,ITI,ITI2
2022-09-04T17:00:00,ITA,02,Valle d'Aosta,45.73750286,7.320149366,3,0,3,736,739,-7,20,42476,547,,,43762,551341,140620,,0,,,11528,32234,143602,407739,ITC,ITC2
2022-09-04T17:00:00,ITA,05,Veneto,45.43490485,12.33845213,347,20,367,45647,46014,-376,1630,2145302,15382,,,2206698,32910102,5067236,,2,,,913333,1293365,10597726,22312376,ITH,ITH3
